我 喜 欢 吃 火 锅 P P P P P P P	S I like to eat hotpot P P P P P P P	I like to eat hotpot P P P P P P P E
他 在 办 公 室 工 作 P P P P P P	S He works in an office P P P P P P P	He works in an office P P P P P P P E
学 生 们 在 图 书 馆 学 习 P P P P	S The students are studying in the library P P P P P	The students are studying in the library P P P P P E
这 个 蛋 糕 很 好 吃 P P P P P P	S This cake is delicious P P P P P P P P	This cake is delicious P P P P P P P P E
她 每 天 早 上 跑 步 P P P P P P	S She runs every morning P P P P P P P P	She runs every morning P P P P P P P P E
这 部 电 影 非 常 有 趣 P P P P P	S The movie is very interesting P P P P P P P	The movie is very interesting P P P P P P P E
中 国 政 府 致 力 于 经 济 发 展 P P	S The Chinese government is working on economic development P P P P	The Chinese government is working on economic development P P P P E
孩 子 们 在 公 园 玩 耍 P P P P P	S The children are playing in the park P P P P P	The children are playing in the park P P P P P E
我 的 手 机 没 电 了 P P P P P P	S My phone is out of battery P P P P P P	My phone is out of battery P P P P P P E
我 们 需 要 更 多 的 科 学 家 P P P	S We need more scientists P P P P P P P P	We need more scientists P P P P P P P P E
她 是 一 名 医 生 P P P P P P P	S She is a doctor P P P P P P P P	She is a doctor P P P P P P P P E
他 正 在 学 习 英 语 P P P P P P	S He is learning English P P P P P P P P	He is learning English P P P P P P P P E
他 们 计 划 去 旅 行 P P P P P P	S They are planning to travel P P P P P P P	They are planning to travel P P P P P P P E
春 天 的 花 开 得 真 美 P P P P P	S The flowers in spring are beautiful P P P P P P	The flowers in spring are beautiful P P P P P P E
他 们 家 的 猫 非 常 可 爱 P P P P	S The cat in their house is very cute P P P P	The cat in their house is very cute P P P P E
他 喜 欢 听 摇 滚 音 乐 P P P P P	S He likes to listen to rock music P P P P P	He likes to listen to rock music P P P P P E
她 去 年 去 了 法 国 P P P P P P	S She went to France last year P P P P P P	She went to France last year P P P P P P E
我 希 望 明 天 是 个 好 天 气 P P P	S I hope it is a nice day tomorrow P P P P	I hope it is a nice day tomorrow P P P P E
他 的 自 行 车 被 盗 了 P P P P P	S His bicycle was stolen P P P P P P P P	His bicycle was stolen P P P P P P P P E
他 们 在 食 堂 吃 午 饭 P P P P P	S They are having lunch in the cafeteria P P P P P	They are having lunch in the cafeteria P P P P P E
她 正 在 写 一 篇 论 文 P P P P P	S She is writing a paper P P P P P P P	She is writing a paper P P P P P P P E
他 是 一 名 软 件 工 程 师 P P P P	S He is a software engineer P P P P P P P	He is a software engineer P P P P P P P E
这 个 季 节 很 多 树 叶 都 掉 了 P P	S Many leaves are falling this season P P P P P P	Many leaves are falling this season P P P P P P E
她 去 年 结 婚 了 P P P P P P P	S She got married last year P P P P P P P	She got married last year P P P P P P P E
他 每 天 都 会 读 报 纸 P P P P P	S He reads the newspaper every day P P P P P P	He reads the newspaper every day P P P P P P E
他 们 在 会 议 室 开 会 P P P P P	S They are having a meeting in the conference room P P P	They are having a meeting in the conference room P P P E
他 是 一 名 警 察 P P P P P P P	S He is a police officer P P P P P P P	He is a police officer P P P P P P P E
她 是 一 名 护 士 P P P P P P P	S She is a nurse P P P P P P P P	She is a nurse P P P P P P P P E
他 喜 欢 打 篮 球 P P P P P P P	S He likes to play basketball P P P P P P P	He likes to play basketball P P P P P P P E
她 是 一 名 律 师 P P P P P P P	S She is a lawyer P P P P P P P P	She is a lawyer P P P P P P P P E
他 们 一 家 计 划 在 夏 天 去 海 滩 P	S Their family is planning to go to the beach in the summer	Their family is planning to go to the beach in the summer E
他 正 在 画 一 幅 画 P P P P P P	S He is painting a picture P P P P P P P	He is painting a picture P P P P P P P E
她 是 一 名 教 师 P P P P P P P	S She is a teacher P P P P P P P P	She is a teacher P P P P P P P P E
他 是 一 名 工 程 师 P P P P P P	S He is an engineer P P P P P P P P	He is an engineer P P P P P P P P E
他 们 正 在 看 电 影 P P P P P P	S They are watching a movie P P P P P P P	They are watching a movie P P P P P P P E
她 是 一 名 艺 术 家 P P P P P P	S She is an artist P P P P P P P P	She is an artist P P P P P P P P E
他 是 一 名 厨 师 P P P P P P P	S He is a chef P P P P P P P P	He is a chef P P P P P P P P E
她 是 一 名 司 机 P P P P P P P	S She is a driver P P P P P P P P	She is a driver P P P P P P P P E
他 们 正 在 超 市 购 物 P P P P P	S They are shopping at the supermarket P P P P P P	They are shopping at the supermarket P P P P P P E
他 是 一 名 老 人 P P P P P P P	S He is an old man P P P P P P P	He is an old man P P P P P P P E
她 是 一 名 儿 童 P P P P P P P	S She is a child P P P P P P P P	She is a child P P P P P P P P E
他 们 是 一 对 朋 友 P P P P P P	S They are a pair of friends P P P P P P	They are a pair of friends P P P P P P E
她 是 一 名 邻 居 P P P P P P P	S She is a neighbor P P P P P P P P	She is a neighbor P P P P P P P P E
