我 喜 欢 吃 火 锅 	I like to eat hotpot.
他 在 办 公 室 工 作 	He works in an office.
学 生 们 在 图 书 馆 学 习 	The students are studying in the library.
这 个 蛋 糕 很 好 吃 	This cake is delicious.
她 每 天 早 上 跑 步 	She runs every morning.
这 部 电 影 非 常 有 趣 	The movie is very interesting.
中 国 政 府 致 力 于 经 济 发 展 	The Chinese government is working on economic development.
孩 子 们 在 公 园 玩 耍 	The children are playing in the park.
我 的 手 机 没 电 了 	My phone is out of battery.
我 们 需 要 更 多 的 科 学 家 	We need more scientists.
她 是 一 名 医 生 	She is a doctor.
他 正 在 学 习 英 语 	He is learning English.
他 们 计 划 去 旅 行 	They are planning to travel.
春 天 的 花 开 得 真 美 	The flowers in spring are beautiful.
他 们 家 的 猫 非 常 可 爱 	The cat in their house is very cute.
他 喜 欢 听 摇 滚 音 乐 	He likes to listen to rock music.
她 去 年 去 了 法 国 	She went to France last year.
我 希 望 明 天 是 个 好 天 气 	I hope it is a nice day tomorrow.
他 的 自 行 车 被 盗 了 	His bicycle was stolen.
他 们 在 食 堂 吃 午 饭 	They are having lunch in the cafeteria.
她 正 在 写 一 篇 论 文 	She is writing a paper.
他 是 一 名 软 件 工 程 师 	He is a software engineer.
这 个 季 节 很 多 树 叶 都 掉 了 	Many leaves are falling this season.
她 去 年 结 婚 了 	She got married last year.
他 每 天 都 会 读 报 纸 	He reads the newspaper every day.
他 们 在 会 议 室 开 会 	They are having a meeting in the conference room.
他 是 一 名 警 察 	He is a police officer.
她 是 一 名 护 士 	She is a nurse.
他 喜 欢 打 篮 球 	He likes to play basketball.
她 是 一 名 律 师 	She is a lawyer.
他 们 一 家 计 划 在 夏 天 去 海 滩 	Their family is planning to go to the beach in the summer.
他 正 在 画 一 幅 画 	He is painting a picture.
她 是 一 名 教 师 	She is a teacher.
他 是 一 名 工 程 师 	He is an engineer.
他 们 正 在 看 电 影 	They are watching a movie.
她 是 一 名 艺 术 家 	She is an artist.
他 是 一 名 厨 师 	He is a chef.
她 是 一 名 司 机 	She is a driver.
他 们 正 在 超 市 购 物 	They are shopping at the supermarket.
他 是 一 名 老 人 	He is an old man.
她 是 一 名 儿 童 	She is a child.
他 们 是 一 对 朋 友 	They are a pair of friends.
她 是 一 名 邻 居 	She is a neighbor.
